0 0 0 0 0 0 0 0 0 0 0 0 0 0 0 0 0 0 0 0 0 0 0 0 0 0 0 0 0 0 0 0 0 0 0 0 0 0 0 0 0 0 0 0 0 0 0 0 0 0 
0 0 0 0 0 0 0 0 0 0 0 0 0 0 0 0 0 0 0 0 0 0 0 0 0 0 0 0 0 0 0 0 0 0 0 0 0 0 0 0 0 0 0 0 0 0 0 0 0 0 
0 0 0 0 0 0 0 0 0 0 0 0 0 0 0 0 0 0 0 0 0 0 0 0 0 0 0 0 0 0 0 0 0 0 0 0 0 0 0 0 0 0 0 0 0 0 0 0 0 0 
0 0 0 0 0 0 0 0 0 0 0 0 0 0 0 0 0 0 0 0 0 0 0 0 0 0 0 0 0 0 0 0 0 0 0 0 0 0 0 0 0 0 0 0 0 0 0 0 0 0 
0 0 0 0 0 0 0 0 0 0 0 0 0 0 0 0 0 0 0 0 0 0 0 0 0 0 0 0 0 0 0 0 0 0 0 0 0 0 0 0 0 0 0 0 0 0 0 0 0 0 
0 0 0 0 0 0 0 0 0 0 0 0 0 0 0 0 0 0 0 0 0 0 0 0 0 0 0 0 0 0 0 0 0 0 0 0 0 0 0 0 0 0 0 0 0 0 0 0 0 0 
0 0 0 0 0 0 0 40 40 40 40 40 40 40 40 40 40 40 40 40 40 40 40 40 40 40 40 40 40 40 40 40 40 40 40 40 40 40 40 40 40 40 40 0 0 0 0 0 0 0 
0 0 0 0 0 0 0 40 45 39 40 40 40 40 40 40 40 40 40 40 40 40 40 40 40 40 40 40 40 40 40 40 40 40 40 40 40 40 40 40 40 40 40 0 0 0 0 0 0 0
0 0 0 0 0 0 0 40 39 39 40 40 40 40 40 39 39 39 39 39 39 40 40 40 40 40 40 40 40 40 40 39 39 39 39 39 39 40 40 40 40 40 40 0 0 0 0 0 0 0 
0 0 0 0 0 0 0 40 40 39 40 40 40 40 39 39 39 39 39 39 39 39 40 40 40 40 40 40 40 40 39 39 39 39 40 40 39 40 40 40 40 40 40 0 0 0 0 0 0 0 
0 0 0 0 0 0 0 40 40 39 39 39 39 39 39 39 39 39 39 39 39 39 40 40 40 40 39 39 39 39 39 39 39 40 40 40 39 39 40 40 40 40 40 0 0 0 0 0 0 0 
0 0 0 0 0 0 0 40 40 40 40 40 40 40 39 39 39 39 39 39 39 39 40 40 40 39 39 39 39 39 39 39 40 40 40 40 40 39 40 40 40 40 40 0 0 0 0 0 0 0 
0 0 0 0 0 0 0 40 40 40 40 40 40 40 40 39 39 39 39 39 39 40 40 40 39 39 39 39 39 39 40 40 40 40 40 40 40 39 39 40 40 40 40 0 0 0 0 0 0 0 
0 0 0 0 0 0 0 40 40 40 40 40 40 40 40 40 40 40 39 40 40 40 40 39 39 39 39 40 40 40 40 40 40 40 40 40 39 39 39 39 40 40 40 0 0 0 0 0 0 0 
0 0 0 0 0 0 0 40 40 40 40 40 40 40 40 40 40 40 39 40 40 40 39 39 39 40 40 40 40 40 40 40 40 40 40 39 39 39 39 39 40 40 40 0 0 0 0 0 0 0 
0 0 0 0 0 0 0 40 40 40 40 40 40 40 40 39 39 39 39 39 40 40 39 39 39 40 40 39 40 40 40 40 40 40 40 39 39 39 39 39 39 40 40 0 0 0 0 0 0 0 
0 0 0 0 0 0 0 40 40 40 40 40 40 39 39 39 40 39 39 39 40 40 39 40 40 40 40 39 40 40 40 40 40 40 39 39 39 39 39 39 39 40 40 0 0 0 0 0 0 0 
0 0 0 0 0 0 0 40 39 39 40 40 40 40 40 40 40 40 39 40 40 40 39 40 40 39 39 39 39 39 40 40 39 39 39 40 40 39 39 39 40 40 40 0 0 0 0 0 0 0 
0 0 0 0 0 0 0 40 39 39 39 39 39 40 40 40 40 40 39 40 40 40 39 40 40 39 39 39 39 39 40 39 39 40 40 40 40 40 39 40 40 40 40 0 0 0 0 0 0 0 
0 0 0 0 0 0 0 40 39 39 39 39 39 40 40 40 40 40 39 40 40 40 39 40 40 39 39 39 39 39 39 39 40 40 40 40 40 40 39 40 40 40 40 0 0 0 0 0 0 0 
0 0 0 0 0 0 0 40 39 39 39 39 39 40 40 40 40 40 39 40 40 40 39 40 40 40 39 39 39 39 40 40 40 40 40 40 40 40 39 40 40 40 40 0 0 0 0 0 0 0 
0 0 0 0 0 0 0 40 39 39 39 39 39 40 40 40 40 40 39 40 40 40 39 39 40 40 40 40 40 40 40 40 40 40 40 40 40 40 39 40 40 40 40 0 0 0 0 0 0 0 
0 0 0 0 0 0 0 40 40 40 39 40 40 40 40 40 40 40 39 40 39 39 39 39 40 40 40 40 40 40 40 40 40 40 40 40 40 40 39 40 40 40 40 0 0 0 0 0 0 0 
0 0 0 0 0 0 0 40 40 40 39 40 40 40 40 40 40 40 39 40 40 40 40 40 40 40 40 40 40 40 40 40 40 40 40 40 40 39 39 39 39 40 40 0 0 0 0 0 0 0 
0 0 0 0 0 0 0 40 40 40 39 40 40 40 39 39 39 39 39 39 39 39 40 40 40 40 40 40 40 40 40 40 40 40 39 39 39 39 39 39 39 40 40 0 0 0 0 0 0 0 
0 0 0 0 0 0 0 40 40 40 39 40 40 39 39 39 39 39 39 39 39 39 39 40 40 40 40 40 40 40 40 40 39 39 39 39 39 39 39 39 39 40 40 0 0 0 0 0 0 0 
0 0 0 0 0 0 0 40 40 40 39 39 39 39 39 39 39 39 39 39 39 39 39 40 40 40 40 40 40 40 40 40 39 39 39 39 39 39 39 39 39 40 40 0 0 0 0 0 0 0 
0 0 0 0 0 0 0 40 40 40 39 39 39 39 39 39 39 39 39 39 39 39 39 40 40 40 40 40 40 40 40 40 39 39 39 39 39 39 39 39 39 40 40 0 0 0 0 0 0 0 
0 0 0 0 0 0 0 40 40 40 40 40 40 40 39 39 39 39 39 39 39 39 39 39 39 39 39 39 39 39 39 39 39 39 39 39 39 40 40 39 39 40 40 0 0 0 0 0 0 0 
0 0 0 0 0 0 0 40 40 40 40 40 40 40 40 40 40 39 39 40 40 40 40 40 40 40 39 40 40 40 40 40 39 39 39 40 40 40 40 39 39 40 40 0 0 0 0 0 0 0 
0 0 0 0 0 0 0 40 40 40 40 40 40 40 40 40 40 39 39 40 40 40 40 40 40 40 39 40 40 40 40 40 40 40 40 40 40 40 39 39 39 40 40 0 0 0 0 0 0 0 
0 0 0 0 0 0 0 40 40 40 40 40 40 40 40 40 40 39 39 40 40 40 40 40 40 40 39 40 40 40 40 40 40 40 40 40 40 40 40 39 39 40 40 0 0 0 0 0 0 0 
0 0 0 0 0 0 0 40 40 40 40 40 40 40 40 40 40 39 39 40 40 40 40 40 40 40 39 40 40 40 40 40 40 40 40 40 40 40 40 40 40 40 40 0 0 0 0 0 0 0 
0 0 0 0 0 0 0 40 40 40 40 40 40 40 40 40 40 39 39 40 40 40 40 40 40 39 39 39 40 40 40 40 40 40 40 40 40 40 40 40 40 40 40 0 0 0 0 0 0 0 
0 0 0 0 0 0 0 40 40 40 40 40 40 40 40 40 40 39 39 40 40 40 40 40 40 39 39 39 40 40 40 40 40 40 40 40 40 40 40 40 40 40 40 0 0 0 0 0 0 0 
0 0 0 0 0 0 0 40 40 40 40 40 40 40 40 39 39 39 39 39 39 40 40 40 40 40 40 40 40 40 40 40 40 40 40 40 40 40 40 40 40 40 40 0 0 0 0 0 0 0 
0 0 0 0 0 0 0 40 40 40 40 40 40 40 40 39 39 39 39 39 39 40 40 40 40 40 40 40 40 40 40 40 40 40 40 40 40 40 40 40 40 40 40 0 0 0 0 0 0 0 
0 0 0 0 0 0 0 40 40 39 39 39 39 39 39 39 39 39 39 39 39 40 40 40 40 40 40 40 40 40 40 40 40 40 40 40 39 39 39 39 39 40 40 0 0 0 0 0 0 0 
0 0 0 0 0 0 0 40 40 39 40 40 40 40 40 39 39 39 39 39 39 40 40 40 40 40 40 40 40 40 40 40 39 39 39 39 39 39 40 40 39 40 40 0 0 0 0 0 0 0 
0 0 0 0 0 0 0 40 40 39 40 40 40 40 40 39 39 39 39 39 39 40 40 40 40 40 40 40 40 40 40 39 39 39 39 39 39 40 40 40 39 40 40 0 0 0 0 0 0 0 
0 0 0 0 0 0 0 40 39 39 39 40 40 40 40 39 39 39 39 39 39 39 39 39 39 39 39 39 39 39 39 39 39 39 39 39 39 40 40 40 39 40 40 0 0 0 0 0 0 0 
0 0 0 0 0 0 0 40 39 46 39 40 40 40 40 40 40 40 40 40 40 40 40 40 40 40 40 40 40 40 40 40 39 39 39 39 39 40 40 40 39 40 40 0 0 0 0 0 0 0
0 0 0 0 0 0 0 40 39 39 39 40 40 40 40 40 40 40 40 40 40 40 40 40 40 40 40 40 40 40 40 40 40 40 40 40 40 40 40 40 40 40 40 0 0 0 0 0 0 0 
0 0 0 0 0 0 0 40 40 40 40 40 40 40 40 40 40 40 40 40 40 40 40 40 40 40 40 40 40 40 40 40 40 40 40 40 40 40 40 40 40 40 40 0 0 0 0 0 0 0 
0 0 0 0 0 0 0 0 0 0 0 0 0 0 0 0 0 0 0 0 0 0 0 0 0 0 0 0 0 0 0 0 0 0 0 0 0 0 0 0 0 0 0 0 0 0 0 0 0 0 
0 0 0 0 0 0 0 0 0 0 0 0 0 0 0 0 0 0 0 0 0 0 0 0 0 0 0 0 0 0 0 0 0 0 0 0 0 0 0 0 0 0 0 0 0 0 0 0 0 0 
0 0 0 0 0 0 0 0 0 0 0 0 0 0 0 0 0 0 0 0 0 0 0 0 0 0 0 0 0 0 0 0 0 0 0 0 0 0 0 0 0 0 0 0 0 0 0 0 0 0 
0 0 0 0 0 0 0 0 0 0 0 0 0 0 0 0 0 0 0 0 0 0 0 0 0 0 0 0 0 0 0 0 0 0 0 0 0 0 0 0 0 0 0 0 0 0 0 0 0 0 
0 0 0 0 0 0 0 0 0 0 0 0 0 0 0 0 0 0 0 0 0 0 0 0 0 0 0 0 0 0 0 0 0 0 0 0 0 0 0 0 0 0 0 0 0 0 0 0 0 0 
0 0 0 0 0 0 0 0 0 0 0 0 0 0 0 0 0 0 0 0 0 0 0 0 0 0 0 0 0 0 0 0 0 0 0 0 0 0 0 0 0 0 0 0 0 0 0 0 0 0 
